111111111111111
100000000000001
102003002003001
100000000000001
103001003001001
100000000000001
101002001002001
100000000000001
111111111111111